1111111111111111111
1000001000000000001
10C01C1001001E0C001
1000101001001000001
10P0111001001100001
1000000C0000C10C001
1111111111111111111